1111111111111111111
111CE1H101HHH001111
1H0H000H00000H00001
100H011111111000101
100000C00000P100H01
1001111111111111111
1111111111111111111