1111111111111111111
111C010101000001111
1000000000000E00001
1000011111111000101
1E00H0C00000P100001
1001111111111111111
1111111111111111111
1111111111111111111