1111111111111111111
111CE10101HHH001111
1000000000000000001
1000000000000000101
1000000000H1P100H01
1001111111111111111
1111111111111111111