1111111111111111111
1111111111111111111
100000CE00000000001
1000000000000000001
1000000100000PH0001
1000000H00000000001
1000000000000000001
1111111111111111111