1111111111111111111
11PCE10101H11001111
1000000000000000001
1000000000000000001
1000000000000000001
10H1111111111111111
1111111111111111111